############
#.0........#
#.#.#.#.#.##
#..........#
##.#.#.#.#.#
#..........#
#.#.#.#.#.##
#..........#
##.#.#.#.#.#
#........1.#
#.#.#.#.#.##
############
